0,0,0,0,0,0,0,0,0,0
0,r,r,r,r,r,r,r,r,0
0,r,0,0,0,0,r,0,r,0
0,r,r,r,0,0,r,0,r,0
0,0,0,r,0,0,r,0,r,0
0,r,r,s,r,r,r,0,r,0
0,r,0,s,0,r,0,0,r,0
0,r,0,s,0,r,0,0,r,0
0,r,r,s,r,r,r,r,r,0
0,0,0,0,0,0,0,0,0,0